###############
#       MMMMM #
# K   C M . M #
# B     M   M #
#       MMMMM #
#             #
# @ 5    .  B #
#             #
#   $~~~.     #
#         B   #
###############