VISION 2
##########
#@       #
#        #
#   $    #
#        #
#      . #
##########
