#############
#@    #     #
#     #  B  #
# K   # F . #
#     M     #
# C   # P . #
#     #  B  #
#     # $~. #
#############
