VISION 2
###############
#             #
#  @          #
#             #
#             #
#             #
#          .  #
#          $  #
#             #
#             #
###############
