VISION 3
#############
#@  B #     #
#     #     #
#     #     #
#     # F.B #
#     #     #
#     # $~.B#
# K   #     #
#     M P . #
# C   #   B #
#############
