########
#@     #
#      #
#  $$  #
#  ..  #
########
