###########
#@   #    #
#    #    #
# K  M $. #
#    #    #
# C  # $. #
#    #  B #
#    #    #
###########
