##########
#@       #
#  ##    #
# $~~~.  #
#   ##   #
#  $  .  #
#  B     #
##########
