###############
#     MMMMM   #
#     M . M   #
#     M   M   #
#     MMMMM   #
#             #
# @     H   B #
#             #
#       C   K #
# $ B   .     #
###############
