TIEMPO 120
#########
#@ K C  #
####M####
#       #
#  .$   #
#       #
#########
