###############
#             #
#    .        #
#    F        #
#     @       #
#             #
#             #
#             #
#             #
###############
