########
#@$   .#
#  ~   #
#    F.#
########
